xxxxxxxxxxxxxxxxxxxxxxxxxxxxxxxxxxxxxxxxxxxxxx
x                           l                x 
x               c                            x
x                                 x p x      x
x                xxx-xxxx                    x
x               x        x           l       x
x               x   E                        x
x                xxxxxxxx                    x
xpppp ppppxxxxxxxxxxxxxxxxxwxwxwxxwxx        x
x         |          x              x        x
x    S    x          |              x        x
xxxxxxxxxxxxxxxxxxxxxxxxxxxxxxxxxxxxxxxxxxxxxx
