xxxxxxxxxxxxxxxxxxxxxxxxxxxxxxxxxxxxxxxxxxxxxx
x                                            x 
x        t      c                            x
x                                 x p x      x
x         c      xxx-xxxx                    x
x               x l      x                   x
x  E            x        k         l         x
x                xxxxxxxx                    x
xpppp ppppxxxxxxxxxxxxxxxxxxxxxxxwxxx        x
x         |          x              x        x
x S       x          |              x        x
xxxxxxxxxxxxxxxxxxxxxxxxxxxxxxxxxxxxxxxxxxxxxx
