xxxxxxxxxxxxxxxxxxxxxxxxxxxxxxxxxxxxxxxxxxxxxx
x                                            x 
x               c                            x
x                                 x p x      x
x                xxx-xxxx                    x
x               x        x              x    x
x               x   E                        x
x                xxxxxxxx               p    x
xpppp ppppxxxxxxxxxxxxxxxxxxxxxwxxxxx        x
x         |          x              |        x
x    S    x          |              x        x
xxxxxxxxxxxxxxxxxxxxxxxxxxxxxxxxxxxxxxxxxxxxxx
