xxxxxxxxxxxxxxxxxxxxxxxxxxxxxxxxxxxxxxxxxxxxxx
x                                            x 
x                                            x
x                                            x
x                                            x
x                                            x
x                                            x
x                                            x
x         xxxxxxxxxxxxxxxxxxxxxxxxxxx        x
x         |          x              x        x
x         x          x              x        x
xxxxxxxxxxx          |              xxxx-xxxxx
x                    x                       x
x                    x                       x
x          xxxxxxxxxxxxxxxxxxx               x
x          x        x        |               x
x          x        x        x               x
x          xxxxxxxxxxxxxxxxxxx               x
x                                            x
x          xxxxxxxxxxxxxxxxxxx               x
x          x        x        x               x
x          x        x        x               x
x    c     x        x        x               x
x          x        x        x               x
xxxxxxxxxxxx                 xxxxx   xxxxxxxxx
x                                            x
x                                            x
x   S                                        x
x                z                           x                              
x                                            x                              
x                       E                    x                              
x                                            x               
x                                            x
x                                            x
x                x                           x                              
x                x                           x                              
xxxxxxxx         x     c                     x              
x      x         x                           x
x      |         x                           x           
xxxxxxxxxxxxxxxxxxxxxxxxxxxxxxxxxxxxxxxxxxxxxx