xxxxxxxxxxxxxxxxxxxxxxxxxxxxxxxxxxxxxxxxxxxxxx
x                           l                x 
x               c                            x
x                                 x p x      x
x                xxx-xxxx                    x
x               x l      x           l       x
x  E            x        k                   x
x                xxxxxxxx                    x
xpppp ppppxxxxxxxxxxxxxxxxxwxwxwxxwxx        x
x         |          x              x        x
x S       x          |              x        x
xxxxxxxxxxxxxxxxxxxxxxxxxxxxxxxxxxxxxxxxxxxxxx
